# # # # # # # P # # # # # # # #
# C . O . . . . . . . . . . . #
# . . O . . . . . . . . . . . #
# . . O D . . . . . . . O . . #
# C R O . . . . . . D . O . . #
# . . O D . . . . . . . O . . #
# . . O . . . . . . D . O . . #
# . . O . . . . . . . . O . . #
# . . R . . . . . . . . R . K #
# # # # # # # P # # # # # # # #

