 # # # # # # # P # # # # # # # #
 # O K O . . . . . . R . . O . #
 # . . R . . . . . . O . . C . #
 # O O . . . . . . . O O O . O #
 # O O . . O O O . . . . R . K #
 # O O . O O O . O O O O O R O #
 # O . R . . O . K O O . . R . #
 # K . . O . K . . O . . . . . #
 # O O . O . . R . O . . . . . #
 # # # # # # # # # # # # P # # #

